13 13
3 3 3 3 3 3 3 3 3 3 3 3 3
3 1 1 2 1 1 2 1 1 2 1 1 3
3 1 3 2 3 2 3 2 3 2 3 1 3
3 1 1 2 1 1 2 1 1 2 1 1 3
3 1 3 2 3 2 3 2 3 2 3 1 3
3 1 1 2 1 1 2 1 1 2 1 1 3
3 1 3 2 3 2 3 2 3 2 3 1 3
3 1 1 2 1 1 2 1 1 2 1 1 3
3 1 3 2 3 2 3 2 3 2 3 1 3
3 1 1 2 1 1 2 1 1 2 1 1 3
3 1 3 2 3 2 3 2 3 2 3 1 3
3 1 1 2 1 1 2 1 1 2 1 1 3
3 3 3 3 3 3 3 3 3 3 3 3 3
